(0,0)
(512,512)
111110000000011*
1111100000000111
1100000000000000
1110000000000000
1110000000000000
1100000000000000
0000000000000000
0000000000000000
1000011010000000
0000011110000000
0000000000000000
