(128,128)
(512,512)
0000011111111000
0000000000000000
0000000000000000
0000000000000000
0000000000000000
0000000000000000
1000000000000000
1000000000000000
0111100000000000
1000000000000000
1000000000000000
